11 20
1 0
10 12
********************
                  **
* ************ ** **
* **           ** **
* ************ ** **
*            * ** **
* ****** *** **** **
* ****** ***      **
* ****** ***********
*              *****
************ *******


